R 10000 10000  
 NO ./images/NO.xpm
SO    ./images/SO.xpm   
   WE ./images/WE.xpm

EA ./images/EA.xpm

S ./images/ITEM.xpm
F 110 , 153 , 15   


C 255 , 255 , 255

        1111111111111111111111111
        1000000000000000000000001
        1100000000000000000000001
        1000002000000000000000001
111111111000000000000000000000001
100000000000000000000000000001111
10000000002000S111111100000001
1000000000000001     100000001
1000000000000001 111 100000001
1000000000000001 1010100000001
100000000000000111000000000001
1100000111010101 1111011110101
11110111 1110121 101111010001
11111111 1111111 111111111111